36 20
960 200
5 5  5  5  5  5  5  5  5  5  5  5  5  5  5  5  5  5  5  5  5  5  5  5  5  5 5 5 5 5 5 5 5 5 5 5
5 33 33 33 33 33 33 33 33 33 33 33 33 33 33 33 33 33 33 33 33 33 33 33 33 4 1 1 1 1 2 2 2 2 2 5
5 33 20 20 33 33 33 33 33 33 33 33 33 33 33 33 33 33 33 33 33 20 20 33 33 4 1 1 1 1 2 2 2 2 2 5
5 33 20 20 33 33 33 33 33 33 33 33 33 33 33 33 33 33 33 33 33 20 20 33 33 4 1 1 1 1 2 2 2 2 3 5
5 33 20 20 33 33 33 33 33 33 33 33 33 33 33 33 33 33 33 33 33 20 20 33 33 4 1 1 1 1 2 2 2 2 3 5
5 33 20 20 33 33 33 33 33 33 33 33 33 33 33 33 33 33 33 33 33 20 20 33 33 4 1 1 1 1 2 2 2 2 3 5
5 33 20 20 33 33 33 33 33 33 33 0  0  0  33 33 33 33 33 33 33 20 20 33 33 4 1 1 1 1 2 2 2 2 3 5
5 33 20 20 33 33 33 33 33 33 33 0  0  0  33 33 33 33 33 33 33 20 20 33 33 4 1 1 1 1 2 2 2 2 2 5
5 33 33 33 33 33 33 33 33 33 33 0  0  0  33 33 33 33 33 33 33 33 33 33 33 4 1 1 1 1 2 2 2 2 2 5
5 33 33 33 33 33 33 33 33 33 33 0  0  0  33 33 33 33 33 33 33 33 33 33 33 4 1 1 1 1 2 2 2 2 3 5
5 33 33 33 33 33 33 33 33 33 33 0  0  0  33 33 33 33 33 33 33 33 33 33 33 4 1 1 1 1 2 2 2 2 3 5
5 14 14 14 14 14 14 14 14 14 22 23 24 14 14 14 22 23 24 14 14 14 22 23 24 4 1 1 1 1 2 2 2 2 3 5
5 14 14 14 14 14 14 14 14 14 25 26 27 14 14 14 25 26 27 14 14 14 25 26 27 4 1 1 1 1 2 2 2 2 3 5
5 14 14 14 14 14 14 14 14 14 28 29 30 14 14 14 28 29 30 14 14 14 28 29 30 4 1 1 1 1 2 2 2 2 2 5
5 2  2  2  2  2  2  2  2  2  2  2  2  2  2  2  2  2  2  2  2  2  2  2  2  2 2 2 2 2 2 2 2 2 2 5
5 2  2  2  2  2  2  2  2  2  2  2  2  2  2  2  2  2  2  2  2  2  2  2  2  2 2 2 2 2 2 2 2 2 3 5
5 2  2  2  2  2  2  2  2  3  3  3  3  2  2  3  3  3  3  2  2  3  3  3  3  2 2 2 2 2 2 2 2 2 3 5
5 2  2  2  2  2  2  2  2  2  2  2  2  2  2  2  2  2  2  2  2  2  2  2  2  2 2 2 2 2 2 2 2 2 3 5
5 2  2  2  2  2  2  2  2  2  2  2  2  2  2  2  2  2  2  2  2  2  2  2  2  2 2 2 2 2 2 2 2 2 3 5
5 5  5  5  5  5  5  5  5  5  5  5  5  5  5  5  5  5  5  5  5  5  5  5  5  5 5 5 5 5 5 5 5 5 5 5