17 17
300 200
5 5 5 5 5 5 5 5 5 5 5 5 5 5 5 5 5
5 8 8 8 8 8 8 8 8 8 8 8 8 8 8 8 5
5 8 8 6 6 6 6 6 6 6 6 6 6 6 8 8 5
5 8 8 6 8 8 6 6 6 6 6 8 8 8 8 8 5
5 8 8 6 8 8 8 8 8 8 8 8 8 8 8 8 5
5 8 8 6 8 8 8 8 8 8 8 8 8 8 8 8 5
5 8 8 8 8 8 8 8 8 8 7 7 7 7 7 8 5
5 8 8 8 8 8 8 6 8 8 8 7 7 7 7 8 5
5 8 8 8 8 8 8 6 8 8 8 8 7 7 7 8 5
5 8 8 8 8 8 8 6 8 8 8 8 8 8 8 8 5
5 8 8 6 8 8 8 6 6 8 8 8 8 8 8 8 5
5 8 8 6 8 8 8 8 6 8 8 8 8 8 8 8 5
5 8 8 6 8 8 8 8 6 8 8 8 8 8 8 8 5
5 8 8 8 8 8 8 8 8 8 7 7 7 7 8 8 5
5 8 8 8 8 8 8 7 7 7 7 7 7 8 8 8 5
5 8 8 8 8 8 8 8 8 8 8 8 8 8 8 8 5
5 5 5 5 5 5 5 5 5 5 5 5 5 5 5 5 5