62 36
400 300
5 5  5  5  5  5  5  5  5  5  5  5  5  5  5  5  5  5  5  5  5  5  5  5  5  5  5  5  5  5  5  5  5  5  5  5  5  5  5  5  5  5  5  5 5  5  5  5  5  5  5  5  5  5  5  5  5  5  5  5  5  5
5 31 31 31 31 31 31 31 31 31 31 31 31 31 31 31 32 32 32 32 32 32 32 32 32 32 32 32 32 32 32 32 32 32 32 32 32 32 32 0  0  20 20 0 0  0  0  20 20 0  32 32 32 32 32 32 32 32 32 32 32 5
5 31 31 31 31 31 31 31 31 31 31 31 31 31 31 31 32 32 32 32 32 32 32 32 7  8  8  8  9  32 32 32 32 32 32 32 32 32 32 0  0  20 20 0 0  0  0  20 20 0  32 32 32 32 32 32 32 32 32 32 32 5
5 31 31 31 31 31 31 31 31 31 31 31 31 31 31 31 32 32 32 32 32 32 7  8  6  6  6  6  6  9  32 32 32 32 32 32 32 32 32 0  0  20 20 0 0  0  0  20 20 0  32 32 32 32 32 32 32 32 32 32 32 5
5 31 31 31 31 31 31 31 31 31 31 31 31 31 31 31 32 32 32 32 32 32 6  6  6  6  6  6  6  6  32 32 32 32 32 32 32 32 32 0  0  20 20 0 0  0  0  20 20 0  32 32 32 32 32 32 32 7  8  9  32 5
5 31 31 31 31 31 31 31 31 31 31 31 31 31 31 31 32 32 32 32 32 32 6  6  6  6  6  6  6  32 32 32 32 32 32 32 32 32 32 0  0  20 20 0 0  0  0  20 20 0  32 32 32 32 32 32 32 6  6  15 32 5
5 31 31 31 31 31 31 31 31 31 31 31 31 31 31 31 32 32 32 32 32 32 6  6  6  6  6  6  32 32 32 32 32 32 32 32 32 32 32 0  0  20 20 0 0  0  0  20 20 0  32 32 32 32 32 32 32 6  6  15 32 5
5 31 31 31 31 31 31 31 31 31 31 31 31 31 31 31 32 32 32 32 32 32 6  6  6  6  6  6  32 32 32 32 32 32 32 32 32 32 32 0  0  20 20 0 0  0  0  20 20 0  32 32 32 32 32 32 32 6  6  15 32 5
5 31 31 31 31 31 31 31 31 31 31 31 31 31 31 31 32 32 32 32 32 32 6  6  6  6  6  6  32 32 32 32 32 32 32 32 32 32 32 0  0  20 20 0 0  0  0  20 20 0  32 32 32 32 32 32 32 6  6  15 32 5
5 31 31 31 31 31 31 31 31 31 31 31 31 31 31 31 32 32 32 32 32 32 6  6  6  6  6  6  32 32 32 32 32 32 32 32 32 32 32 0  0  20 20 0 0  0  0  20 20 0  32 32 32 32 32 32 32 6  6  15 32 5
5 31 31 31 31 31 31 31 31 31 31 31 31 31 31 31 32 32 32 32 32 32 6  6  6  6  6  6  32 32 32 32 32 32 32 32 32 32 32 0  0  20 20 0 0  0  0  20 20 0  32 32 32 32 32 32 32 6  6  15 32 5
5 31 31 31 31 31 31 31 31 31 31 31 31 31 31 31 32 32 32 32 32 32 6  6  6  6  6  6  32 32 32 32 32 32 32 32 32 32 32 0  0  20 20 0 0  0  0  20 20 0  32 32 32 32 32 32 32 6  6  15 32 5
5 31 31 31 31 31 31 31 31 31 31 31 31 31 31 31 32 32 32 32 32 32 6  6  6  6  6  6  32 32 32 32 32 32 32 32 32 32 32 0  0  20 20 0 0  0  0  20 20 0  32 32 32 32 32 32 32 6  6  15 32 5
5 31 31 31 31 31 31 31 31 31 31 31 31 31 31 31 32 32 32 32 32 32 6  6  6  6  6  6  6  6  6  6  6  6  6  6  6  6  32 0  0  0  0  0 0  0  0  0  0  0  32 32 7  8  8  8  8  6  6  15 32 5
5 31 31 31 31 31 31 31 31 31 31 31 31 31 31 31 32 32 32 32 32 32 32 32 32 32 32 32 32 32 32 32 32 32 32 32 32 32 32 0  0  0  0  0 0  0  0  0  0  0  32 32 6  6  6  6  6  6  6  15 32 5
5 22 23 24 14 14 14 22 23 24 14 14 14 22 23 24 14 14 14 22 23 24 14 14 14 22 23 24 14 14 14 22 23 24 14 14 14 22 23 24 14 14 0  0 0  0  0  0  0  0  32 32 10 11 11 11 11 11 11 12 32 5
5 25 26 27 14 14 14 25 26 27 14 14 14 25 26 27 14 14 14 25 26 27 14 14 14 25 26 27 14 14 14 25 26 27 14 14 14 25 26 27 14 14 0  0 0  0  0  0  0  0  32 32 32 32 32 32 32 32 32 32 32 5
5 28 29 30 14 14 14 28 29 30 14 14 14 28 29 30 14 14 14 28 29 30 14 14 14 28 29 30 14 14 14 28 29 30 14 14 14 28 29 30 14 14 0  0 0  0  0  6  6  0  32 32 32 32 32 32 32 32 32 32 32 5
5 4  4  4  4  4  4  4  4  4  4  4  4  4  4  4  4  4  4  4  4  4  4  4  4  4  4  4  4  4  4  4  4  4  4  4  4  4  4  4  4  4  0  0 0  0  4  4  4  4  4  4  4  4  4  4  4  4  4  4  4 5
5 1  1  1  1  1  1  1  1  1  1  1  1  1  1  1  1  1  1  1  1  1  1  1  1  1  1  1  1  1  1  1  1  1  1  1  1  1  1  1  1  1  1  1 1  1  1  1  1  1  1  1  1  1  1  1  1  1  1  1  1 5
5 1  1  1  1  1  1  1  1  1  1  1  1  1  1  1  1  1  1  1  1  1  1  1  1  1  1  1  1  1  1  1  1  1  1  1  1  1  1  1  1  1  1  1 1  1  1  1  1  1  1  1  1  1  1  1  1  1  1  1  1 5
5 1  1  1  1  1  1  1  1  1  1  1  1  1  1  1  1  1  1  1  1  1  1  1  1  1  1  1  1  1  1  1  1  1  1  1  1  1  1  1  1  1  1  1 1  1  1  1  1  1  1  1  1  1  1  1  1  1  1  1  1 5
5 2  2  2  2  2  2  2  2  2  2  2  2  2  2  2  2  2  2  2  2  2  2  2  2  2  2  2  2  2  2  2  2  2  2  2  2  2  2  2  2  2  2  2 2  2  2  2  2  2  2  2  2  2  2  2  2  2  2  2  2 5
5 2  2  2  2  2  2  2  2  2  2  2  2  2  2  2  2  2  2  2  2  2  2  2  2  2  2  2  2  2  2  2  2  2  2  2  2  2  2  2  2  2  2  2 2  2  2  2  2  2  2  2  2  2  2  2  2  2  2  2  2 5
5 2  2  2  2  2  2  2  2  2  2  2  2  2  2  2  2  2  2  2  2  2  2  2  2  2  2  2  2  2  2  2  2  2  2  2  2  2  2  2  2  2  2  2 2  2  2  2  2  2  2  2  2  2  2  2  2  2  2  2  2 5
5 2  2  2  2  2  2  2  2  2  2  2  2  2  2  2  2  2  2  2  2  2  2  2  2  2  2  2  2  2  2  2  2  2  2  2  2  2  2  2  2  2  2  2 2  2  2  2  2  2  2  2  2  2  2  2  2  2  2  2  2 5
5 3  3  3  2  2  3  3  3  3  2  2  3  3  3  3  2  2  3  3  3  3  2  2  3  3  3  3  2  2  3  3  3  3  2  2  3  3  3  3  2  2  3  3 3  3  2  2  3  3  3  3  2  2  3  3  3  3  2  2  3 5
5 2  2  2  2  2  2  2  2  2  2  2  2  2  2  2  2  2  2  2  2  2  2  2  2  2  2  2  2  2  2  2  2  2  2  2  2  2  2  2  2  2  2  2 2  2  2  2  2  2  2  2  2  2  2  2  2  2  2  2  2 5
5 2  2  2  2  2  2  2  2  2  2  2  2  2  2  2  2  2  2  2  2  2  2  2  2  2  2  2  2  2  2  2  2  2  2  2  2  2  2  2  2  2  2  2 2  2  2  2  2  2  2  2  2  2  2  2  2  2  2  2  2 5
5 2  2  2  2  2  2  2  2  2  2  2  2  2  2  2  2  2  2  2  2  2  2  2  2  2  2  2  2  2  2  2  2  2  2  2  2  2  2  2  2  2  2  2 2  2  2  2  2  2  2  2  2  2  2  2  2  2  2  2  2 5
5 2  2  2  2  2  2  2  2  2  2  2  2  2  2  2  2  2  2  2  2  2  2  2  2  2  2  2  2  2  2  2  2  2  2  2  2  2  2  2  2  2  2  2 2  2  2  2  2  2  2  2  2  2  2  2  2  2  2  2  2 5
5 1  1  1  1  1  1  1  1  1  1  1  1  1  1  1  1  1  1  1  1  1  1  1  1  1  1  1  1  1  1  1  1  1  1  1  1  1  1  1  1  1  1  1 1  1  1  1  1  1  1  1  1  1  1  1  2  2  2  2  2 5
5 1  1  13 13 13 1  1  1  1  13 13 13 1  1  1  1  13 13 13 1  1  1  1  13 13 13 1  1  1  1  13 13 13 1  1  1  1  13 13 13 1  1  1 1  13 13 13 1  1  1  1  13 13 13 1  2  2  2  2  3 5
5 1  1  1  1  1  1  1  1  1  1  1  1  1  1  1  1  1  1  1  1  1  1  1  1  1  1  1  1  1  1  1  1  1  1  1  1  1  1  1  1  1  1  1 1  1  1  1  1  1  1  1  1  1  1  1  2  2  2  2  3 5
5 1  1  1  1  1  1  1  1  1  1  1  1  1  1  1  1  1  1  1  1  1  1  1  1  1  1  1  1  1  1  1  1  1  1  1  1  1  1  1  1  1  1  1 1  1  1  1  1  1  1  1  1  1  1  1  2  2  2  2  2 5
5 5  5  5  5  5  5  5  5  5  5  5  5  5  5  5  5  5  5  5  5  5  5  5  5  5  5  5  5  5  5  5  5  5  5  5  5  5  5  5  5  5  5  5 5  5  5  5  5  5  5  5  5  5  5  5  5  5  5  5  5 5