62 36
400 300
5 5  5  5  5  5  5  5  5  5  5  5  5  5  5  5  5  5  5  5  5  5  5  5  5  5  5  5  5  5  5  5  5  5  5  5  5  5  5  5  5  5  5  5 5  5  5  5  5  5 5 5  5  5  5  5  5  5  5  5  5 5
5 0  0  0  0  0  0  0  0  0  0  0  0  0  0  0  7  8  9  0  0  0  0  0  0  0  0  0  0  0  0  0  0  0  0  0  16 17 0  0  0  20 20 0 0  0  0  20 20 0 0 0  0  0  0  0  0  0  0  0  0 5
5 0  0  0  0  0  0  0  0  0  0  0  0  0  0  0  6  6  6  0  0  0  0  0  0  0  0  0  0  0  0  0  0  0  0  0  20 21 0  0  0  20 20 0 0  0  0  20 20 0 0 0  0  0  0  0  0  0  0  0  0 5
5 0  0  0  0  0  0  0  0  0  0  0  0  0  0  0  6  6  6  0  0  0  7  8  8  8  8  9  0  0  0  0  0  0  0  0  20 21 0  0  0  20 20 0 0  0  0  20 20 0 0 0  0  0  0  0  0  0  0  0  0 5
5 0  0  0  0  0  0  0  0  0  0  0  0  0  0  0  10 11 12 0  0  0  6  6  6  6  6  6  0  0  0  6  6  6  0  0  20 21 0  0  0  20 20 0 0  0  0  20 20 0 0 0  0  0  0  0  0  7  8  9  0 5
5 0  0  0  0  0  0  0  0  0  0  0  0  0  0  0  0  0  0  0  0  0  6  6  6  6  6  6  0  0  0  0  0  0  0  0  20 21 0  0  0  20 20 0 0  0  0  20 20 0 0 0  0  0  0  0  0  6  6  15 0 5
5 0  0  0  0  0  0  0  0  0  0  0  0  0  0  0  0  0  0  0  0  0  6  6  6  6  6  6  0  0  0  0  0  0  0  0  20 21 0  0  0  20 20 0 0  0  0  20 20 0 0 0  0  0  0  0  0  6  6  15 0 5
5 0  0  0  0  0  0  0  0  0  0  0  0  0  0  0  0  0  0  0  0  0  6  6  6  6  6  6  0  0  0  0  0  0  0  0  20 21 0  0  0  20 20 0 0  0  0  20 20 0 0 0  0  0  0  0  0  6  6  15 0 5
5 0  0  0  0  0  0  0  0  0  0  0  0  0  0  0  0  0  0  0  0  0  10 11 11 11 11 12 0  0  0  0  0  0  0  0  20 21 0  0  0  20 20 0 0  0  0  20 20 0 0 0  0  0  0  0  0  6  6  15 0 5
5 0  0  0  0  0  0  0  0  0  0  0  0  0  0  0  0  0  0  0  0  0  0  0  0  0  0  0  0  0  0  0  0  0  0  0  20 21 0  0  0  20 20 0 0  0  0  20 20 0 0 0  0  0  0  0  0  6  6  15 0 5
5 0  0  0  0  0  0  0  0  0  0  0  0  0  0  0  0  0  0  0  0  0  0  0  0  0  0  0  0  20 20 20 20 20 20 20 20 21 0  0  0  20 20 0 0  0  0  20 20 0 0 0  0  0  0  0  0  6  6  15 0 5
5 0  0  0  0  0  0  0  0  0  0  0  0  0  0  0  0  0  0  0  0  0  0  0  0  0  0  0  0  18 18 18 18 18 18 18 18 19 0  0  0  20 20 0 0  0  0  20 20 0 0 0  0  0  0  0  0  6  6  15 0 5
5 0  0  0  0  0  0  0  0  0  0  0  0  0  0  0  0  0  0  0  0  0  0  0  0  0  0  0  0  0  0  0  0  0  0  0  0  0  0  0  0  20 20 0 0  0  0  20 20 0 0 0  0  0  0  0  0  6  6  15 0 5
5 0  0  0  0  0  0  0  0  0  0  0  0  0  0  0  0  0  0  0  0  0  0  0  0  0  0  0  0  0  0  0  0  0  0  0  0  0  0  0  0  0  0  0 0  0  0  0  0  0 0 0  7  8  8  8  8  6  6  15 0 5
5 0  0  0  0  0  0  0  0  0  0  0  0  0  0  0  0  0  0  0  0  0  0  0  0  0  0  0  0  0  0  0  0  0  0  0  0  0  0  0  0  0  0  0 0  0  0  0  0  0 0 0  6  6  6  6  6  6  6  15 0 5
5 22 23 24 14 14 14 22 23 24 14 14 14 22 23 24 14 14 14 22 23 24 14 14 14 22 23 24 14 14 14 22 23 24 14 14 14 22 23 24 14 14 0  0 0  0  0  0  0  0 0 0  10 11 11 11 11 11 11 12 0 5
5 25 26 27 14 14 14 25 26 27 14 14 14 25 26 27 14 14 14 25 26 27 14 14 14 25 26 27 14 14 14 25 26 27 14 14 14 25 26 27 14 14 0  0 0  0  0  0  0  0 0 0  0  0  0  0  0  0  0  0  0 5
5 28 29 30 14 14 14 28 29 30 14 14 14 28 29 30 14 14 14 28 29 30 14 14 14 28 29 30 14 14 14 28 29 30 14 14 14 28 29 30 14 14 0  0 0  0  0  6  6  0 0 0  0  0  0  0  0  0  0  0  0 5
5 4  4  4  4  4  4  4  4  4  4  4  4  4  4  4  4  4  4  4  4  4  4  4  4  4  4  4  4  4  4  4  4  4  4  4  4  4  4  4  4  4  0  0 0  0  4  4  4  4 4 4  4  4  4  4  4  4  4  4  4 5
5 1  1  1  1  1  1  1  1  1  1  1  1  1  1  1  1  1  1  1  1  1  1  1  1  1  1  1  1  1  1  1  1  1  1  1  1  1  1  1  1  1  1  1 1  1  1  1  1  1 1 1  1  1  1  1  1  1  1  1  1 5
5 1  1  1  1  1  1  1  1  1  1  1  1  1  1  1  1  1  1  1  1  1  1  1  1  1  1  1  1  1  1  1  1  1  1  1  1  1  1  1  1  1  1  1 1  1  1  1  1  1 1 1  1  1  1  1  1  1  1  1  1 5
5 1  1  1  1  1  1  1  1  1  1  1  1  1  1  1  1  1  1  1  1  1  1  1  1  1  1  1  1  1  1  1  1  1  1  1  1  1  1  1  1  1  1  1 1  1  1  1  1  1 1 1  1  1  1  1  1  1  1  1  1 5
5 2  2  2  2  2  2  2  2  2  2  2  2  2  2  2  2  2  2  2  2  2  2  2  2  2  2  2  2  2  2  2  2  2  2  2  2  2  2  2  2  2  2  2 2  2  2  2  2  2 2 2  2  2  2  2  2  2  2  2  2 5
5 2  2  2  2  2  2  2  2  2  2  2  2  2  2  2  2  2  2  2  2  2  2  2  2  2  2  2  2  2  2  2  2  2  2  2  2  2  2  2  2  2  2  2 2  2  2  2  2  2 2 2  2  2  2  2  2  2  2  2  2 5
5 2  2  2  2  2  2  2  2  2  2  2  2  2  2  2  2  2  2  2  2  2  2  2  2  2  2  2  2  2  2  2  2  2  2  2  2  2  2  2  2  2  2  2 2  2  2  2  2  2 2 2  2  2  2  2  2  2  2  2  2 5
5 2  2  2  2  2  2  2  2  2  2  2  2  2  2  2  2  2  2  2  2  2  2  2  2  2  2  2  2  2  2  2  2  2  2  2  2  2  2  2  2  2  2  2 2  2  2  2  2  2 2 2  2  2  2  2  2  2  2  2  2 5
5 3  3  3  2  2  3  3  3  3  2  2  3  3  3  3  2  2  3  3  3  3  2  2  3  3  3  3  2  2  3  3  3  3  2  2  3  3  3  3  2  2  3  3 3  3  2  2  3  3 3 3  2  2  3  3  3  3  2  2  3 5
5 2  2  2  2  2  2  2  2  2  2  2  2  2  2  2  2  2  2  2  2  2  2  2  2  2  2  2  2  2  2  2  2  2  2  2  2  2  2  2  2  2  2  2 2  2  2  2  2  2 2 2  2  2  2  2  2  2  2  2  2 5
5 2  2  2  2  2  2  2  2  2  2  2  2  2  2  2  2  2  2  2  2  2  2  2  2  2  2  2  2  2  2  2  2  2  2  2  2  2  2  2  2  2  2  2 2  2  2  2  2  2 2 2  2  2  2  2  2  2  2  2  2 5
5 2  2  2  2  2  2  2  2  2  2  2  2  2  2  2  2  2  2  2  2  2  2  2  2  2  2  2  2  2  2  2  2  2  2  2  2  2  2  2  2  2  2  2 2  2  2  2  2  2 2 2  2  2  2  2  2  2  2  2  2 5
5 2  2  2  2  2  2  2  2  2  2  2  2  2  2  2  2  2  2  2  2  2  2  2  2  2  2  2  2  2  2  2  2  2  2  2  2  2  2  2  2  2  2  2 2  2  2  2  2  2 2 2  2  2  2  2  2  2  2  2  2 5
5 1  1  1  1  1  1  1  1  1  1  1  1  1  1  1  1  1  1  1  1  1  1  1  1  1  1  1  1  1  1  1  1  1  1  1  1  1  1  1  1  1  1  1 1  1  1  1  1  1 1 1  1  1  1  1  2  2  2  2  2 5
5 1  1  13 13 13 1  1  1  1  13 13 13 1  1  1  1  13 13 13 1  1  1  1  13 13 13 1  1  1  1  13 13 13 1  1  1  1  13 13 13 1  1  1 1  13 13 13 1  1 1 1  13 13 13 1  2  2  2  2  3 5
5 1  1  1  1  1  1  1  1  1  1  1  1  1  1  1  1  1  1  1  1  1  1  1  1  1  1  1  1  1  1  1  1  1  1  1  1  1  1  1  1  1  1  1 1  1  1  1  1  1 1 1  1  1  1  1  2  2  2  2  3 5
5 1  1  1  1  1  1  1  1  1  1  1  1  1  1  1  1  1  1  1  1  1  1  1  1  1  1  1  1  1  1  1  1  1  1  1  1  1  1  1  1  1  1  1 1  1  1  1  1  1 1 1  1  1  1  1  2  2  2  2  2 5
5 5  5  5  5  5  5  5  5  5  5  5  5  5  5  5  5  5  5  5  5  5  5  5  5  5  5  5  5  5  5  5  5  5  5  5  5  5  5  5  5  5  5  5 5  5  5  5  5  5 5 5  5  5  5  5  5  5  5  5  5 5